0 0 0 0 0 0 0 0 0 0 0 0 0 0 0 0 0 0 0 0 0 0 0 0 0 0 0 0 0 0 0 0 0 0 0 0 0 0 0 0 0 0 0 0 0 0 0 0 0 0 0 0 
0 0 0 0 0 0 0 0 0 0 0 0 0 0 0 0 0 0 0 0 0 0 0 0 0 0 0 0 0 0 0 0 0 0 0 0 0 0 0 0 0 0 0 0 0 0 0 0 0 0 0 0 
0 0 0 0 0 0 0 0 0 0 0 0 0 0 0 0 0 0 0 0 0 0 0 0 0 0 0 0 0 0 0 0 0 0 0 0 0 0 0 0 0 0 0 0 0 0 0 0 0 0 0 0 
0 0 0 0 0 0 0 0 0 0 0 0 0 0 0 0 0 0 0 0 0 0 0 0 0 0 0 0 0 0 0 0 0 0 0 0 0 0 0 0 0 0 0 0 0 0 0 0 0 0 0 0 
0 0 0 0 0 0 0 0 1 2 0 0 1 2 0 0 0 0 3 4 5 0 0 0 0 0 0 0 0 0 0 0 0 0 0 0 0 0 0 0 0 0 0 0 0 0 0 0 0 0 0 0 
0 0 0 0 0 0 0 0 6 7 0 0 6 7 0 0 0 0 8 9 10 0 0 0 11 0 0 0 0 0 0 0 0 0 0 0 0 0 0 0 0 0 0 0 0 0 0 0 0 0 0 0 
0 0 0 0 0 0 0 0 0 0 0 0 0 0 0 0 0 0 0 0 0 0 0 0 12 0 0 0 0 0 0 0 0 0 0 0 0 0 0 0 0 0 0 0 0 0 0 0 0 0 0 0 
0 13 14 0 0 0 0 0 0 0 0 0 0 0 0 0 0 0 0 0 0 0 0 0 0 0 0 0 0 0 0 0 0 0 0 0 0 0 0 0 0 0 0 0 0 0 0 0 0 0 0 0 
0 15 16 0 0 0 0 0 0 0 0 0 0 0 0 0 0 0 0 0 0 0 0 0 0 0 0 11 0 0 0 0 11 17 0 0 0 11 0 0 0 11 0 0 0 11 0 0 0 0 0 0 
0 0 0 0 0 0 0 0 0 0 0 0 0 0 0 0 0 0 0 0 0 0 0 0 0 0 0 12 0 0 0 0 12 18 0 0 0 12 0 0 0 12 0 0 0 12 0 0 0 0 0 0 
0 0 0 0 0 0 0 0 0 0 0 0 0 0 0 0 0 0 0 0 0 0 0 0 0 0 0 0 0 0 0 0 0 0 0 0 0 0 0 0 0 0 0 0 0 0 0 0 11 17 0 0 
0 0 0 0 0 0 0 0 0 0 0 0 0 0 0 0 0 0 0 0 0 0 0 0 0 0 0 0 0 0 0 0 0 0 0 0 0 0 0 0 0 0 0 0 0 0 0 0 12 18 0 0 
0 0 0 0 0 0 0 0 0 0 0 0 0 0 0 0 0 0 0 0 0 0 0 0 0 0 0 0 0 0 0 0 0 0 0 0 0 0 0 0 0 0 0 0 0 0 0 0 0 0 0 0 
0 0 0 19 20 19 21 19 20 0 0 19 20 19 21 19 20 0 0 0 0 0 0 0 0 0 0 0 0 0 0 0 0 0 0 0 0 0 0 0 0 0 0 0 0 0 0 0 0 0 0 0 
0 0 0 22 23 24 25 22 23 0 0 22 23 24 25 22 23 0 0 0 0 0 0 0 0 0 0 0 0 0 0 0 0 0 0 0 0 0 0 0 0 0 0 0 0 0 0 0 0 0 0 11 
0 0 0 26 27 28 29 26 27 0 0 26 27 28 29 26 27 0 0 0 0 0 0 0 0 0 0 0 0 0 0 0 0 0 0 0 0 0 0 0 0 0 0 0 0 0 21 19 20 19 21 30 
0 0 0 24 25 31 32 33 34 0 0 35 36 37 38 24 25 0 0 0 0 0 0 0 0 0 0 39 40 41 0 0 0 0 42 43 44 0 0 0 0 45 0 0 0 0 25 22 23 24 25 46 
0 0 0 28 29 47 48 49 12 0 0 30 50 51 52 53 29 0 0 54 55 0 0 45 0 0 42 56 57 58 59 60 61 62 63 61 63 61 63 61 64 65 66 67 68 69 29 26 27 28 29 26 
0 0 0 22 23 70 71 46 72 73 0 46 72 70 71 74 23 75 60 76 77 63 78 65 79 63 61 63 78 80 81 82 82 82 82 82 82 83 84 85 86 87 88 89 90 91 23 24 92 93 94 95 
96 62 61 26 27 28 29 97 98 69 99 100 98 28 29 47 27 101 82 82 84 85 86 87 88 84 83 85 86 87 88 89 102 103 84 83 85 104 105 87 87 87 106 107 108 109 27 28 90 91 91 91 
84 84 110 95 25 22 23 90 91 91 91 91 91 22 23 70 25 83 103 85 111 112 112 113 87 105 104 87 106 112 112 114 105 115 105 104 87 87 87 87 106 116 117 91 118 109 25 22 119 120 121 122 
107 107 123 91 124 100 98 108 109 109 109 109 109 100 125 126 127 128 129 116 117 91 91 130 131 112 112 116 117 91 91 130 131 112 132 132 132 132 133 116 117 134 109 109 109 109 124 100 135 135 136 137 
91 91 118 109 91 91 91 118 109 109 109 109 109 91 138 138 138 138 139 140 109 109 109 109 141 91 91 140 109 109 109 109 141 91 138 138 138 138 139 140 109 109 109 109 109 109 91 91 91 91 91 142 
